11111
10001
10001
10001
11a11
