NO ./north.xpm
SO ./south.xpm
WE ./west.xpm
EA ./east.xpm


F 100,100,100
C 228,228,228


        1111111111111111111111111
        1000000000110000000000001
        10110000011100000100010011111111111
        1001100000000000000000000000000000111111111
1111111110110000011100000000000011111110000000000011111111111111111111111
100000000011000001110111111111111    100111111110000000000000000000000001
11110111111111011100000010001        100111111110000000000000000000000011
11110111111111011101010010001        100111111110000000000000000000000001
11000000110101011100000010001        10011111111000000N000000000000000001
10001000000000000000000000001        100111111110000000000000000000000001
10000000000000001101010010001        100111111110000000000000000000000001
1100000111010101111101111000111      100000000000011111111111111111111111
11110111 1110101 101111010001        11111111111111
11111111 1111111 111111111111


