NO ./textures/north.xpm
SO ./textures/south.xpm
WE ./textures/west.xpm
EA ./textures/east.xpm


F 100,100,100
C 228,228,228

111111
100001
10N111
1001
1111
