1111111111111111111111111
1000000000110000000000001
1011000001110000000000001
100100000000001000000000111111111
111111111011000001110000000000001
100000000011000001110111111111111
111101111111110111000000100011
111101111111110111010100100011
110000001101010111000000100011
100000000000000011000000100011
100000000000000011010100100011111111111
1100000111000001111101101N0000000000001
111101111110101111111110000110000000001
111111111111111111111111111111111111111